15 15
O3333333333333u
410000110000114
410110100110004
410110000111104
410110001111104
400111100000004
401100001111114
401100111000004
401111100000104
400000001111104
411000001100104
4P1111111000104
401000011010104
400011000010004
y3333333333333i