10 9
O3333333u
400010004
401010104
401010104
401010104
401010104
4P1010104
401010104
400000004
y3333333i