10 10
O33333333u
4011111004
4010001004
4010101004
40000000P4
4010101104
4010101104
4010100004
4000111114
y33333333i