15 10
O33333333u
4000000004
4011010004
4011010114
4000000004
4111010104
4100000104
4101P11104
4101011104
4000000004
4000011014
4011011014
4000000004
4111111004
y33333333i