15 10
O33333333u
4000000004
4011111104
4011100104
4000100104
4110100104
4110000004
4110110104
4110110004
4000111114
4011000004
4011011104
4P00000104
4111110004
y33333333i