15 15
O3333333333333u
410000111000004
400110000011104
400010110011104
400010110011104
400010110000004
4P0010111111104
411110111111104
400000000000004
401111101101104
400100101101104
400000101101104
400010100100004
410000110000114
y3333333333333i