15 15
O3333333333333u
40000000000P004
401110110110104
401110000010104
401111110010104
400000010010104
411111010000004
400000011010114
401111111010014
400000001011014
411111101000014
400000001101114
401111111100004
400000000000004
y3333333333333i